a kent face  -  commonly used in scotland when a person has seen a person they know, such as 'i saw a few kent faces in the library'. this idiom has nothing to do with the surname or the place. it is taken from an old english word that means 'to know'.
a load of tosh  -  is used to describe something that is not very good. for example, your lecturer might describe your essay 'as a load of tosh' …. harsh!
a turn off  -  something that’s repulsive.
ace  -  pass a test with 100%.
ace  -  is used to describe something that is awesome. a word that is popular in the north and amongst youngsters.
adam and eve  -  cockney rhyming slang for believe. 'can you adam and eve it!'
any road  -  when you hear this, the person isn’t asking you to pick a road! they are most likely substituting it for 'any way' and the context could be 'any road are you from china or japan.'
around the clock  -  24/7
asap  -  stands for ‘as soon as possible’
asshole - a pleasant fellow
b - ball 
babe  -  your significant other
bail  -  to leave abruptly.
beat  -  tired
bees knees  -  the phrase does not relate to bees or knees but is an idiom for excellent. it became popular in the 1920s along with 'cat’s whiskers.'
bite your arm off  -  don’t be alarmed if someone says this. no one is about to literally bite off any part of your anatomy. it is used to describe willingness. for example someone might say to you 'they will bite your arm off if you offer to write their essay.'
bits ‘n bobs  -  is used these days when you want to say you have an odd selection of things for example you could say 'i have a few bits’n bobs in the fridge. i’ll see what i can make'. however, it was originally used to describe loose change in your pocket.
blow or bomb  -  to fail or to be unsuccessful
blue or have the blues  -  to feel depressed or sad
bob’s your uncle  -  the origins of this saying and how it is used today differ. the saying originally meant you could get anything or do anything if you had the right connections because it came about after the 20th british prime minister, lord salisbury, famously appointed a nephew into an important political post for which he didn’t have the relevant experience. today it is more commonly used to say everything is ok.
bomb  -  really good
booze  -  alcohol
brassed off  -  considering the brits are good at hiding their emotions we still have plenty of words to describe when we are not happy with something. one of which is 'brassed off'.
bro  -  a friend
buck  -  one dollar
bummer  -  a disappointment
busted  -  caught doing something wrong
butcher’s hook  -  originates from the east end of london and is a rhyme slang for take a look.
by the skin of your teeth  -  just barely
cash  -  money
catch a few zzzzzzzzzz  -  is used when you want to go to sleep.
cheerio  -  no it is not just a breakfast cereal but also one of the many words used to say goodbye in the uk. 'ta ta' is popular in the north of england and you will also hear 'laters' and 'see ya'.
cheesed off  -  is a quirky euphemism for being unhappy. obviously you would be unhappy if your cheese went off! it can be used in casual and formal situations for example someone could say 'i’m cheesed off that you ate the last piece of cake.'
cheesy  -  cheap
cheesy  -  silly
chick  -  a girl or young woman
chicken  -  coward
chin wag  -  means to have a long chat and its origins come from a welsh word meaning empty. it is believed that the word originates from a pub in north wales where the landlady would ensure people drunk more than they intended by going around with a jug of ale and toping peoples glasses up by saying 'chin wag' – which is welsh for your cup is empty.
cool  -  nice
couch potato  -  a lazy person
cram  -  to study feverishly before an exam.
crash  -  to fall asleep quickly
daft cow  -  is used amongst friends and is an affectionate way of making fun of a female friend when they have done or said something silly. be aware the meaning changes dramatically when you say this to a stranger!
dead  -  empty
dishy  -  is used to describe someone who is attractive.
ditch  -  to skip an event.
dive  -  is used to describe a place that isn’t very nice. someone may say to you 'it’s a dive but the drinks are cheap'
donkey’s years  -  apparently donkey’s live for a long time so when someone say’s 'i haven’t seen you for donkey’s' they are saying they haven’t seen you in a long time.
don’t cry over spilt milk  -  someone may say this if you get something wrong or actually spill or break something. the essence of the saying is that you shouldn’t worry about it.
don’t teach your grandmother to suck eggs  -  you may hear someone more senior in years saying this to a younger person when they feel the youngster is being disrespectful by thinking they can teach the older person something.
drive up the wall  -  to irritate
dump  -  to end a romantic relationship with someone.
earful  -  is an expression used to describe someone who is being told off. for example, you may hear someone say 'they got an earful for being so loud last night.'
easy peasy  -  a fun and childish way of expressing something is easy to do or understand. we dare you to use it next time your lecturer is explaining something.
eejit  -  an irish
effing and blinding  -  this expression is used to describe someone who is using unpleasant language. for example, you might hear 'she was so angry that she was effing and blinding all the way home!'
elevenses  -  a mid
epic  -  grand or awesome
ex  -  an old relationship or spouse
faff around  -  if you’re faffing around you look busy, but you’re achieving very little. for example: 'i told him to stop faffing around and wash the dishes.'
flakey  -  indecisive
flick  -  a movie
flogging a dead horse  -  to try and find a solution to a problem that is unsolvable. for example: 'you’re flogging a dead horse by asking martha to move to the uk – she hates rain'
for crying out loud  -  this is a replacement for a rude word. for example you discover your bike has a flat tyre & you yell 'oh, for crying out loud!'
freebie  -  something that is free.
from the valley’s  -  an expression used to describe people from wales, owing to the number of valleys (which is the low area between hills) in wales.
full of beans  -  full of beans means someone is very energetic and vivacious.
fyi  -  acronym 'for your information'
get under one’s skin  -  bother
getting hitched  -  getting married
give the cold shoulder  -  ignore
gobby  -  is used to describe someone who talks a lot and has a lot of opinions, and not necessarily in a good way.
gobsmacked  -  if you are gobsmacked you are amazed by something or someone. in a good or bad way!
going to a do  -  student life wouldn’t be student life without a fair dose of parties and if someone invites you to a 'do' say yes because they are inviting you to a party!
grub  -  food
grub  -  is slang for food and comes from the old english word meaning 'dig'. the association with digging for food morphed into the slang we use today.
hammered  -  is the slang word used to describe someone who is very drunk. you can say someone is tipsy if they appear to be a bit drunk.
hang out  -  to spend time with others
have a crush  -  attracted to someone romantically
hip  -  cool, popular.
hit the books  -  study.
hit the road  -  to leave.
hold your horses  -  wait a minute!
horses for courses  -  this is a popular saying that means that we all have different tastes and what is right for one person isn’t necessarily right for another person.
hot  -  attractive
hunky - dory 
hyped  -  really excited.
i feel you  -  i understand and empathize with you
i get it  -  i understand.
in no time  -  very soon.
it is what it is  -  it’s a fact that cannot be changed.
it sucked  -  it was bad/poor quality
it’s brass monkeys outside  -  is used when it is bitterly cold. the origins of this saying refer to the brass handles on doors which get very cold. this bit makes sense but the monkeys bit of this saying is baffling, even to the brits.
i’m down  -  i’m able to join
i’m easy  -  next time you are in a restaurant and your friends are debating what to order just say 'order whatever. i’m easy'. that’s a signal that you’re happy with whatever they order.
i’m not being funny but i haven’t got all day  -  this is a popular saying in wales and simply means hurry up!
i’m off to bedfordshire  -  is rhyming slang for when someone is tired and wants to go to bed. get it?
i’ve come over all peculiar  -  is a peculiar saying used to describe someone who becomes unwell very quickly.
jacked  -  really strong
jammy  -  if you are a lucky person you might be described as flukey or jammy.
jar  -  is slang for a pint of beer. for example: 'let’s meet after the lecture for a few jars.'
jiffy  -  this is a quintessentially british saying meaning you’ll do something immediately. you might say it to show you are keen, for example: 'if you’re cooking dinner i’ll be there in a jiffy.'
jim jams  -  is slang for pyjamas and as a student you’ll hear 'i think it’s time to put on my jim jams and get into bed – i’m exhausted!' – a lot!
jonesing  -  to want something badly.
keep your hair on  -  can you lose your hair if you get too angry or excited? that’s what this idiom suggests. for example: 'keep your hair on – i only accidentally deleted your dissertation.'
kerfuffle  -  is a fuss or commotion. for example: 'what’s all the kerfuffle about? i’m only two hours late!'
kip  -  means sleep
knees up  -  if someone says they went to 'a right knees
laid back  -  relaxed or calm
lairy  -  used to describe a loud/brash person. for example: 'tom gets a bit lairy after a few drinks.'
lame  -  the opposite of cool or fantastic
last order  -  you will hear bar staff, in pubs, shout this and ring a bell at 11pm or at 10.30pm on sunday to let customers know they have 20 minutes in which to finish their drinks.
leave it out  -  means you want someone to stop doing or saying something that you find upsetting or annoying.
let down  -  can be used in a multitude of ways and means you thought the experience was not good. for example: 'that film was such a let down'
lighten up  -  relax
lol  -  text acronym for ‘laugh out loud’
lurgy  -  if someone has the lurgy stay away. it means they are ill and possibly contagious.
miffed  -  is another way of saying you are confused or annoyed. for example: 'she is really miffed that she’s not been invited to the party.'
mind your p’s and q’s  -  means to be on your best behaviour. for example: 'my parents are very conservative – mind your p’s and q’s.'
minted  -  if someone is described as minted it means they are rich, so become their best friend immediately!
mitts  -  a mitten is a kind of glove. but brits have shortened the word and made it slang for hands. for example: 'i’d love to get my mitts on a new camera!'
my bad  -  my mistake.
naff  -  is used to describe something that is of poor or inferior taste. example: 'i don’t like my flat, the furniture is a bit naff.'
no problem  -  you’re welcome
no worries  -  that’s alright.
nosh  -  is slang for food. for example: 'shall we get some nosh before our lecture?'
not my cup of tea  -  is a saying used when something is not to your liking. for example: 'my boyfriend loves football but it’s not my cup of tea'.
numpty  -  if someone does or says something inappropriate, wrong or a bit silly you might hear a brit saying 'you numpty you’ve got your t
odds and sods  -  another way of saying ‘bits and pieces.’ for example: 'my glasses were in the drawer with all the odds and sods.'
oh my giddy aunt  -  is another expression for 'oh my god!' and used to show shock or surprise.
old chestnut  -  if you tell the same joke or story too many times your bored friends may say 'oh no not that old chestnut again' in a sarcastic voice.
omg  -  text acronym for ‘oh my god’.
on the hour  -  an idiom for at every hour exactly
on the lash  -  means to drink excessive amounts of alcohol and you may hear brits saying, 'are you out on the lash tonight?'
once in a blue moon  -  infrequently
one off  -  an expression used to describe something unique. for example: 'i bought this one
party animal  -  one who loves parties.
pass the buck  -  transfer responsibility to someone else.
piece of cake  -  easy or effortless.
piece of cake  -  to describe something as a 'piece of cake' means you think it’s easy to do. for example you might say 'this essay is a piece of cake.'
pig out  -  to eat a lot
pip pip  -  an old fashioned way of saying goodbye.
plonk  -  is used to describe wine and the reference is that it isn’t the best quality wine.
porkies  -  if you are accused of telling a 'porkie' it’s serious. it means someone thinks you are lying. the saying comes from an old cockney rhyme that used pork pies and substituted 'pies,' for 'lies' and it later got shortened to 'porkies'.
put a sock in it  -  if you have had enough of someone talking you can tell them to put a sock in it. it is totally fine to use amongst friends but if you think your lecturer is going on a bit we advise you keep the thought to yourself!
put up a front  -  trying to act or appear tough
quack  -  is slang for a doctor that is suspected of not have the correct qualifications
quasimodo  -  is cockney rhyming slang for soda water.
queen mum  -  is cockney rhyming slang for the backside (bum).
queen of the south  -  is cockney rhyming slang for mouth.
queenie  -  affectionate term brits use to refer to queen elizabeth ii (the current queen)
quid  -  is slang for one
rank  -  is slang for something that is horrible, in bad taste or actually smells unpleasant.
recap  -  to state something again
reem  -  is slang for something being nice, good or cool and originates from essex. in fact to learn how to speak essex you should watch the only way is essex.
ride shotgun  -  to ride in the front passenger seat of a car.
rinsed  -  can be used in a couple of ways. the first is if you defeat someone in an argument, fight or other competition. the second context is when someone pays over the odds for something.
rip - off 
ripped  -  very physically fit
rosie lee  -  is cockney rhyming slang for a cup of tea.
rsvp  -  abbreviation of a french phrase meaning 'please respond'.
same here  -  i agree.
score  -  to get something you want.
screw up  -  to make a mistake
see a man about a dog  -  is what you say when you jokingly don’t want to reveal where you are going, such as going to the toilet.
see ya  -  goodbye
shades  -  sunglasses
shady  -  questionable or suspicious
shagged  -  this can mean a number of things some ruder than others. but the most common use is when someone is expressing how tired they are.
shirty  -  is one way to describe someone who is ill
shoot the breeze  -  casual conversation.
shotgun  -  the front seat of a car.
show up  -  arrive at an event.
sick  -  awesome. eg. 'those shoes are sick!'
skive  -  if you don’t want to go to that 9am lecture (understandable) or rather spend the afternoon in the student’s union then suggest skiving off to a couple of like
snagged/nabbed  -  to take something without asking or slyly
spill the beans  -  reveal a secret.
stitched up  -  is when someone has taken advantage of you. for example, when a classmate nominates you to lead a presentation you can certainly claim to 'have been stitched up.'
stop faffing around  -  if you hear this and it’s aimed at you. finish off whatever you are doing fast! the implication is you are taking too long or you are not doing it efficiently.
sweet  -  fantastic.
take a rain check  -  do at another time.
take for granted  -  to assume.
taking the piss  -  if you hear this being used it means one person is shocked at what another person is doing or saying.
that hit the spot  -  indicates satisfaction when talking about food or drink
the offie  -  the off
they got fired  -  they lost their job.
throw a spanner in the works  -  you are likely to hear this saying when something goes wrong or someone makes a mistake.
tickety - boo 
trash  -  to destroy. 'the band trashed the hotel room.'
trundle  -  means to move slowly and clumsily.
umpteen  -  means a relatively large, but unspecified amount, of something and is generally used when someone is annoyed. for example, you may hear a brit saying 'for the umpteenth time, i said no i will not take the dog for a walk!'
uncle ned  -  slang for bed
under the cosh  -  is used when you feel under pressures or restricted. for example: 'she is under the cosh to deliver that project on time.'
up for it  -  slang for being enthusiastic/willing to participate. for example: 'i like bowling, i’m up for it tonight.'
up the spout  -  when you have wasted something such as money. for example, 'everything i earned over the summer has gone up the spout trying to keep this flat warm.'
v.a.t  -  is slang for vodka and tonic.
veg - out 
vibe  -  is slang for feelings, atmosphere, mood. for example, you may go to a club and say 'i like the vibe in here the music is reem.'
vino  -  is slang for cheap wine.
wangle  -  means to get or do something that is a bit devious. for example: 'i wangled an extension on my essay by telling the lecturer my cat died.'
watering hole  -  this is one of the many slang words for a pub
wee  -  is a scottish word for small. in england it’s a euphemism for urine. confused? don’t be. if a scottish person says they want a wee drink they want a whiskey. if an english person says they want a wee direct them to the nearest toilet!
well in it  -  expression used when someone is in trouble
what’s up?  -  hey; what are you doing?
whiz  -  a really smart person.
wind - up 
wonky  -  is another word for shaky or unstable. you can use it to refer to a person or an object. for example you might say a chair has a wonky leg.
wrap up  -  to finish
x ray eyes  -  you might use the expression 'have you got x
xtra  -  is used to describe something that is very good. you may hear 'that double chocolate chip ice cream is xtra!'
yakking  -  used to describe someone who talks too much about things that aren’t of interest to you. example: 'my lecturer wouldn’t stop yakking on and on today.'
yank my chain  -  if you tease someone about something they are sensitive about they could say to you 'stop yanking my chain' to tell you to stop it.
yonks  -  when you haven’t seen someone for a long time. example: 'god, i haven’t been to a lecture for yonks!'
you bet  -  certainly; you’re welcome.
you what  -  mostly brits use this when they haven’t heard or understood what was said. on some ocasions it might be used when someone disagrees with you. you’ll know which one it is by their tone and body language.
your round  -  if you go to a pub with a group of friends it is most likely that one person will buy the whole group a drink. this will continue until everyone in the group has bought a drink. if it is your turn someone may say 'it is your round'.
you’re a keeper  -  used affectionately to describe someone who is nice or someone who has a good attribute. for example, you might hear 'you can cook – you’re such a keeper.'
zebra crossing  -  is often used to describe the black and white horizontal markings on the road where pedestrians can cross.
